**XXXXXXXX
X*X******X
X*XXXXXX*X
X*XXXXXX*X
X*XXXXXX*X
X*XXXXXX*X
X*XXXXXX*X
X*X******X
X**XXXXXXX
XX********
