...................XXXXX
X.XXXXX.XXXXXXXX.XXXXXXX
X.X..XXX.XXXXXXX.XXXXXXX
X.XXXXX.XXXXXXXX.XXXXXXX
.........XXXXXXX.XXXXXXX
X.XXXXX.XXXXXXXX...XXXXX
X....XXXXXXXXXXXXX.XXXXX
XXXX.....XXXXXXXXX....XX
XXXXXXXX.X.........XXXXX
.........XXXXXXXXXXXXXXX
XXXXXXXX................
