.....XXXX
XXX.XXXXX
XXX..XXXX
XXXX.XXXX
XXX..XXXX
XXXX.....
