***XXXXXXX
X********X
X*XXXXXX*X
X*XXXXXX*X
X*XXXXXX*X
X*XXXXXX*X
X*XXXXXX*X
X********X
X*XXXXXXXX
X*********