***XXXXXXX
X********X
X*XX*XXX*X
X*XX*XXX*X
X*XX*XXX*X
X*XX*XXX*X
X*XX*XXX*X
X********X
X*XXXXXXXX
X*********