***XXXXXXXXXXXX
*X*X*XXXXXXXXXX
*********XXXXXX
*X*X*XXXXXXXXXX
*****XXXXXXXXXX
*X*X*XXXXXXXXXX
*******XXXXXXXX
*X*X*XXXXXXXXXX
***X*XXXXXXXXXX
*X*X*XXXXXXXXXX
*************XX
XXXXXXXX*X*X*XX
XXXXXXXX*****XX
XXXXXXXXXXXX*XX
XXXXXXXXXXXX***